
*******************************************************************************
                        Structure of SRAC File
*******************************************************************************
   
SRAC         : directory for the SRAC code
      -bin   : directory for SRAC load modules
      -cmnd  : directory for private command (set path in .cshrc)
      -lib   : directory for libraries for SRAC95
          -burnlibT  : directory for burnup chain libraries
      -obj   : directory for object modules 
          -SCall     : scalar objects
          -VPpart    : vector objects (only for vector processors)
      -smpl  : directory for sample problems
          -shr       : directory for shell-script and input data
          -outp      : directory for output data
      -src   : directory for source programs
           -srac     : directory for main part of SRAC
           -pij      : directory for Pij part (used also in ASMBURN)
           -cit      : directory for CITATION part (used also in COREBN)
           -burn     : directory for cell burn-up part
           -read     : directory for PDS access part (used also in ASMBURN)
           -common   : common programs (used also in ASMBURN, and COREBN)
           -plot     : directory for plotter part
           -extnl    : directory for system-dependent part
           -sracvp   : directory for vector sources (only for vector processors)
           -citvp    : directory for vector sources (only for vector processors)
           -updtsc   : directory for updated scalar sources (empty)
           -updtvp   : directory for updated vector sources (empty)
           -inc      : directory for include files
      -tmp   : directory for temporary files (work directory)
      -tool  : directory for installation tools
           -install  : directory for SRAC installer
                  -SysDpnd     : directory for system-dependent pre-processors
                      -{*}/PrepInst.sh: system(*)-dependent pre-processor
                      -{*}/lmmake     : template for SRAC/tool/lmmake
                                        (only for vector machines)
                      -Common  : template for SRAC/tool/lmmake (scalar machines)
                  -PrepRset.sh : Uninstaller for pre-processed data
                  -UtilInst.sh : Installer for utility programs
                  -UtilRset.sh : Uninstaller for utility programs
                  -DataInst.sh : Installer for Bickley function table
                  -DataRset.sh : Uninstaller for Bickley function table
                  -ProgInst.sh : Installer for load module
                  -ProgRset.sh : Uninstaller for objects and load modules
                  -OutpRset.sh : Uninstaller for calculated data
                  -menu        : directory for menu of installer
                  -help        : directory for help information
                      -help*.txt      : help information (general)
                      -help.PC1       : help information for PC/AT
                  -custom      : directory for custom-installation menu 
           -kintab   : directory for production of Bickley function table
           -lmmake   : directory for production of objects and load modules
                       this is generated by pre-processor(SysDpnd/*/PrepInst.sh)
                       * : system type = ews-hp, ews-sun, facom-vpp, nec-sx3 ..
                  -objmk : production of object modules
                  -lmupdt: produce or update a load module from objects
                  -lmmk  : production of a load module (not keep objects)
           -permit   : directory for tools to permit SRAC to other users
           -else     : directory for other tools (source conversion, etc.)
                  -F77conv     : converter for FORTRAN compile driver and option
                  -VPconv      : converter for vector control statements
                  -IncConv     : converter for include statements
      -util  : directory for utility programs
           -pdscnvt  : directory for PDStoTXT or TXTtoPDS
           -pdsmdl   : directory for PDSMDL (modular subroutine package)
           -admin    : directory of utilities for administrator of SRAC 
